%%%%%%%%%%%%%%%%%%%
%.       %       .%
% %%%%%% % %%%%%% %
% %%%    %    %%% %
% %%% %%%%%%% %%% %
%   %  . % .  %   %
%%% %%%% % %%%% %%%
%%% %         % %%%
%%% % %%% %%% % %%%
%%% % %    G% % %%%
%%% % %%%%%%% % %%%
%.       %       .%
% %%%%%% % %%%%%% %
% %%%%%% % %%%%%% %
% %%%%%% % %%%%%% %
%        P        %
%%%%%%%%%%%%%%%%%%%
