%%%%%%%
% P   %
% %%% %
% %.  %
%.%%% %
% G  .%
%%%%%%%
